#Example: Large parts of Africa and south east Asia
tropical = {
	#Crabclaw
	436
	#Feldips
	312 313 314 315 316 984
	#Crandor
	58 59 60
	#Kandarin
	291
	#Karamja
	209 210 211 212 213 214 871 872 215 216 217 218 219 220 221 222 223
	224 225 226 227 228 229 230 231 232 233
	975 976 977
	#South Islands
	805 806 234 235 236 237 238 239 978 1409
	#Mudskipper Point
	34
	#Outer Isles
	142 143 144 145 146 147 148 764 765 766 900 1344 1407
	#Tempoross Cove
	1000
	#Kharid
	91
	#Ranul Forest
	497 501 507 508 509 510 522 890 1015
	#Western Wushanko
	1097 1098 1099 1100 1101 1102 1103 1104 1105 1106 1107 1108 1109 1110 1111 1112
	1113 1114 1117 1118 1120 1121 1122 1123 1124 1125 1126 1127 1128
	1129 1130 1131 1132 1133 1134 1135 1136 1137 1138 1139 1140 1141 1142 1143
	#Central Wushanko
	1144 1145 1146 1147 1148 1149 1150 1151 1152 1153 1154 1155 1156 1157 1158 1159
	1160 1161 1162 1163 1164 1165 1166 1167 1168 1169 1170 1171 1172 1173 1174 1175
	1176 1488 1177 1178 1179 1180 1181 1182 1183 1184 1185 1186 1187 1188 1189 1190 1191
	1192 1193 1194 1195 1196 1197 1232
	#Eastern Wushanko
	1198 1199 1200 1201 1202 1203 1204 1205 1206 1207 1208 1209 1210 1211 1212 1213
	1214 1215 1216 1217 1218 1219 1220 1221 1222 1223 1224 1225 1226 1227 1228 1229
	1230 1231 1408
}

arctic = {
	#Wintertodt
	412 413 414 415
	#North Fremmy
	389 390 391 392 393 394 395 396 380 379 378 383 972 973 974 1350
	#Troll/Forinthry
	196 197 359 358 356 966 967 968 969
	#Extra
	373 353 352 351 783 354 355 357
	#Acheron
	1285 1286 1287 1288 1289 1290 1291 1292 1293 1294 1295 1296 1297 1298 1299 1300 1301 1302 1303 1304 1305 1489
}

arid = {
	#Varlamore
	511 512 513 514 515 516 517 518 519 520 523 524 525 891 892 1459 1460 1461 1462 1463
	#Ooglog
	317
	#Kharid except Ullek Swamp and Mage Training
	61 62 63 64 65 68 69 70 71 72 73 74 75 76 77 78 79 80 81 82 83
	84 85 86 87 88 89 90 92 93 94 95 96 97 98 99 100 101 102
	789 867 868 786 787 866 856 854 855 858 859 788 857 1003
	1366 1367 1395
	#Wushanko - skull region
	1115 1116 1119
}

#Example: Most of Europe north of med.
mild_winter = {
	#Kebos/Varlamore
	471 884 477 478 479 480 481 482 483 484 485 506 521 1450 1456
	454 458 879 880 881 484 455 457
	840 841 935 1484
	#Kourend
	398 399 400 401 402 403 404 427 428 429 430 431 876 877
	420 448 476 421 425
	1415 1416 1417 1434
	#Tirannwn
	331 328 327 329 325 770 771 326 1386 1387
	#Fremmy
	785 365 
	#Kandarin
	277 278 275 274 273 272 271 270 269 768 769 268 267
	266 265 264 262 261 260 860 259 258 257 256 255 254 253 252 251
	250 249 248 247 776 861 780 536 775 287
	989 990 991 992 1347
	1376 1377 1378 1379 1380 1410 1411
	1007
	#Forinthry
	151 152 153 154 155 156 157 158 159 160 166 167 168 169 206 
	170 
	956 957
	1234 1237
	#Morytania
	111 112 114 116 117 113 120 842 949
	#Asgarnia
	865 37 38 39 41 44 796 793 56 42
	945 986 987 988 863
	1363 1364
	#Misthalin
	2 5 7 8 9 10 11 12 13 14 15 16 17 18 19 20 22 24 25
	781 782 790 21 23 894 895 901 897
	939 940 941 942
	1355 1356
	1397 1398 1399 1400 1401
	#Outer Isles
	198 199 200 201 202 204 205
	951 952
}

#Example: Inland Europe & Scandinavia
normal_winter = {
	#North Kourend
	453 419 418 873 874 417 875 407 408 409 410 411 405 406 416
	1422 1423 1424 1425 1426 1427 1428 1435
	#Fremmy
	385 388 386 387 381 382 384 376 377 368 372 371 
	366 367 369 784 370
	301 971 322 1233 1391 1392 1394
	#Kandarin
	281 280 779 279 1349
	#Troll Country
	345 346 347 348 349 350 353 
	#North Asgarnia
	43 45 48 795 50 49 51 794
	946 1004 1005 1006
	#Forinthry
	177 178 179 180 181 182 183 184 185 186 187 188 189 190 191 192 193 194
	171 172 173 174 175 176 869 162 163
	161 164 165 150 149
	958 959 960 961 962 963 964 965
	1235 1236 1345 1437 1438 1440
	#Misthalin
	26 27
	#Tirannwn
	324 902
	#Varlamore Mountains
	504 1448 1454 1455
	527 532 533 534 836 837 1471 1472
}

#Example: Russia & Lappland
severe_winter = {
	#Wintertodt
	412 413 414 415
	#Kandarin
	276
	#North Fremmy
	389 390 391 392 393 394 395 396 380 379 378 383 373
	972 973 974 1350
	#Troll/Forinthry
	196 197 359 358 356 357 195 354 355 351 783 352
	969 968 967 966 1439
	1238 1320
	#Ice Mountain
	46 47
	#Acheron
	1285 1286 1287 1288 1289 1290 1291 1292 1293 1294 1295 1296 1297 1298 1299 1300 1301 1302 1303 1304 1305 1489
}

impassable = {
	#Misthalin
	29 30 32
	798 937 1361 1362 1396
	#Asgarnia
	54 55
	811 926 927 944
	#Kharid
	103 104 105 106 107 108 110
	799 1368 1369 1370 1371 1372
	#Morytania
	537 1375 1406
	#Forinthry
	531
	1239 1325 1326
	#Karamja
	242 245
	807 808 809 810
	#Kandarin
	301 303
	823 1348
	#Feldips
	318 323
	819 820 821 822
	#Tirannwn
	344
	824 825 826 827
	#Troll Country
	360 361 362 363 364
	812 813 814 815 816 817 818
	1352 1353 1354
	#Fremennik
	
	#Acheron
	1311 1312 1313 1314 1315 1316 1317 1318 1319
	#Kourend
	444 445 446 447 451 452
	828 829 833
	#Kebos
	526 527 535
	830 831 832 834 835 836 837 838 839
	#Varlamore
	532 533 534	840 841
	1471 1472 1473 1474 1475 1476 1477 1478 1479 1480 1481 1482 1483 1484 1485 1486 1487
}

mild_monsoon = {
	#Crandor/Mudskipper
	34 797 58 59 60
	#North Karamja
	209 210 211 213 214 871 872 975
	#Sheltered Ape Atoll
	236 237 1409
	#Sheltered Braindeath
	764 766
	#Ullek Swamp
	91
	#Feldips
	306 307 308 853 315 316 1011 1012 1013
	#Western Wushanko
	1097 1098 1099 1100 1101 1102 1103 1104 1105 1106 1107 1108 1109 1112
	1113 1114 1115 1116 1117 1118 1119 1120 1121 1122 1123 1124 1125 1126 1127 1128
	1129 1130 1131 1132 1133 1134 1135 1136 1137 1138 1139 1140 1141 1142 1143
	#Central Wushanko
	1144 1145 1146 1147 1148 1149 1150 1151 1152 1153 1154 1155 1156 1157
	1160 1161 1162 1163 1164 1165 1166 1167 1168 1169 1170 1171 1172 1173 1174 1175
	1176 1177 1178 1179 1180 1181 1182 1183 1184 1185 1186 1187 1188 1189 1190 1191
	1192 1193 1194 1195 1196 1197 1232 1488
	#Eastern Wushanko
	1198 1199 1200 1201 1202 1203 1204 1205 1206 1207 1208 1209 1210 1211 1212 1213
	1214 1215 1216 1217 1218 1219 1220 1221 1222 1223 1224 1225 1226 1227 1228 1229
	1230 1231 1408
	#Varlamore
	501 507 508 509 510 522 888 890 1015
}

normal_monsoon = {
	#Ape Atoll
	235 805 234
	#South Karamja
	215 216 217 218 219 220 233 227 976 977
	#Feldips
	313 314 315 984
	#Outer Isles
	142 143 144 148 765 900 1344
	#Wushanko
	1110 1111
	#Varlamore
	496 497 498 499 500
}

severe_monsoon = {
	#Feldips
	312
	#Ape Atoll
	806 238 239 978
	#Karamja
	225 226 224 228 223 222 221 229 230 231 232
	#Outer Isles
	145 146	147
	#Tempoross Cove
	1000
	#Wushanko
	1158
}

equator_y_on_province_image = 656