east_runescape = {
#Misthalin
	1 2 3 4 5 6 7 8 9 10 11 12 13 14 15 16 17 18 19 20 21 22 23 24 25 26 27
	781 782 790 791 792 894 895 896 897 901 938 939 940 941 942
	1355 1356 1367 1358 1359 1360
	1397 1398 1399 1400 1401
#Misthalin Wastelands
	29 30 32 798 937 1361 1362 1396
#Asgarnia
	33 34 35 36 37 38 39 40 41 43 44 45 46 47 48 42 49 50 51 52 56 57 58 59 60
	793 794 795 796 797 863 864 865 943 945 946 986 987 988 1004 1005 1006 1014 1016
	1363 1364 1365
#Asgarnia Wastelands
	54 55 811 926 927 944
#Kharid
	61 62 65 63 64 66 67 68 69 70 71 72
	73 74 75 82 83 76 77 78 79 80 86 87 88 81 84 85 94 95 91 92 93 96 97 98 99 100 89 90 101 102
	786 787 788 789 854 855 856 857 858 859 866 867 868 1000 1003
	1366 1367 1395
#Kharid Wastelands
	103 104 105 106 107 108 110 799 1368 1369 1370 1371 1372
#Morytania
	111 112 113 114 116 117 119 120 115 118 130
	121 122 123 124 125 126 127 128 129 131 132 133 134 136	135 137 138 139 140 
	764 765 766 842 843 844 845 846 847 848 849 850 947 948 949 950 1373 1374
	1402 1403 1404 1405
#Morytania Wastelands
	537 1375 1406
#Forinthry
	149 162 163 176 150 151 160 152 153 158 159 154 155 156 157 161 164 165 174 166 167 168 173 206 169 170 171 172	175 177 178 179
	180 181 182 183 184 185 186 187 188 189 190 191 192 193 194 195 196 197 358 
	869 956 957 958 959 960 961 962 963 964 965 966 1345
	1234 1235 1236 1237 1238 1320 1321 1322 1323 1324
#Forinthry Wastelands
	531 1239 1325 1326
#Outer Isles
	142 143 144 145 146 147 148 900
	198 199 200 202 201 203 204 205 870 951 952 953 954 955 1344 1407
}

west_runescape = {
#Karamja
	209 210 211 212	213 214 215 216 217 218 219	220 221 222 223 233 224 225 226 227 228	229 230 231 232
	806 871 872 975 976 977 
#Karamja Wastelands
	242 808 809 810
#Southern Isles
	234 235 236 237	238 239 805 978 1409
#Southern Isles Wastelands
	245 807
#Kandarin
	247 248 249 250 251	252 253 254 261 255 256 257 258 259 260 263 536 262 264 265 282 283
	266 267 268 269	270 271 272 273 274 275 276 277 278	279 280 281	284 287 288 295 296	285 286 289 290	291 292 293 294
	768 769 775 776 777 778 779 780 851 852 860 861 862
	989 990 991 992 1007 1008 1347 1349
	1376 1376 1377 1378 1379 1380 1381 1382 1383 1384 1385 1410 1411
#Kandarin Wastelands
	301 303 823 1348
#Feldip Hills
	305 306 307 308	309 310 311	312 313 314	315 316 317
	1009 1010 1011 1012 1013
	753 754 755 756 757 758	759 760 761 762 853
	923 924 925 984 985 1346
#Feldip Hills Wastelands
	318 323 819 820 821 822
#Tirannwn
	325 326 327 328 329	324 330 331 332 335	333 334 336 337	338 339	340 341 342 538
	770 771 772 773 774 902 979 980 981 982 983	1240 1241 1242 1243 1244 1245 1246 1247 1248
	1386 1387 1388 1389 1390
#Tirannwn Wastelands
	344 824 825 826 827
#Troll Country
	345 346 347 348	349 350 351 354	352 353 374	355 356 357 359
	783 967 968 969 970 1351
#Troll Country Wastelands
	360 361 362 363 364 812 813 814 815 816 817 818 1252 1253 1254 1352 1353 1354
#Fremennik
	322 365 366	367 368 372 373	369 370 371	376 377	378 379 380	381 382 383 384	386 387 389 390	385 388 391	392 393 394 395 396
	784 785 971 972 973 974
	1233 1350 1391 1392 1393 1394
#Fremennik Wastelands
#Acheron
	1285 1286 1287 1288 1289 1290 1291 1292 1293 1294 1295 1296 1297 1298 1299 1300 1301 1302 1303 1304 1305
#Acheron Wastelands
	1311 1312 1313 1314 1315 1316 1317 1318 1319
}

zeah = {
#Kourend
	398 399 400 401 402 403 428 429	404 405 406 407	408 409 410 411	412 413 414 415 416 417 418 419
	420 448 476	421 423 425 426 427	430 431 432 434 438	433 435 436 437	439 440 441 442 443	422 424 456 465
	873 874 875 876 877
	928 929 930 931 932
	1412 1413 1414 1415 1416 1417 1418 1419 1420 1421 1422 1423 1424 1425 1426 1427 1428 1434 1435
#Kourend Wastelands
	444 445 446 447 451 452 828 829 833
#Kebos
	453 454 458	455 457 459 460 461 462 463 464 466	467 468 469 470 471	477 478 479	480 481 482	483 484 485
	878 879 880 881 882 883 884
	933 934 935 936
	1429 1430 1431 1432 1433
#Kebos Wastelands
	467 526 535 830 831 832 834 835 836 837 838 839
#Varlamore
	486 487 488 489 491 492 493 490 494 495 496 497 498 500 499 509 510 501 506
	507 508 502 503 504 505 522 511 512 513 514 515 516 517 518 519 520 521 523
	524 525 527
	885 886 887 888 889 890 891 892 1015
#Varlamore Wastelands
	532 533 534 840 841
}

wushanko_isles_continent = {
#Arc
	1097 1098 1099 1100 1101 1102 1103 1104 1105 1106 1107 1108 1109 1110 1111
#Skull
	1112 1113 1114 1115 1116 1117 1118 1119 1120 1121 1122 1123 1124 1125 1126 1127
#Hook
	1128 1129 1130 1131 1132 1133 1134 1135 1136 1137 1138 1139 1140 1141 1142 1143
#Scythe
	1144 1145 1146 1147 1148 1149 1150 1151 1152 1153 1154 1155 1156 1157 1158 1159 1232
#Pincers
	1160 1161 1162 1163 1164 1165 1166 1167 1168 1169 1170 1171 1172 1173 1174 1175
#Pincers
	1176 1177 1178 1179 1180 1181 1182 1183 1184 1185 1186 1187 1188 1189 1190 1191
	1192 1193 1194 1195 1196 1197
#Loop
	1198 1199 1200 1201 1202 1203 1204 1205 1206
#Shield
	1207 1208 1209 1210 1211 1212 1213 1214 1215 1216 1217 1218 1219 1220 1221 1222
	1223 1224 1225 1226 1227 1228 1229 1230 1231 1408
}

island_check_provinces = {
	
}

# Used for RNW
new_world = {
}