width = 5632
height = 2048

max_provinces = 6000
sea_starts = {
	539	540	541	542	543	544	545	546	547	548	549	550	551	552	553	554	555	556	557	558
	559	560	561	562	563	564	565	566	567	568	569	570	571	572	573	574	575	576	577	578
	579	580	581	582	583	584	585	586	587	588	589	590	591	593	594	595	596	597	598
	599	600	601	602	603	604	605	606	607	608	609	610	611	612	613	614	615	616	617	618
	619	620	621	622	623	624	625	626	627	628	629	630	631	632	633	634	635	636	637	638
	639	640	641	642	643	644	645	646	647	648	649	650	651	652	653	654	655	656	657	658
	659	660	661	662	663	664	665	666	667	668	669	670	671	672	673	674	675	676	677	678
	679	680	681	682	683	684	685	686	687	688	689	690	691	692	693	694	695	696	697	698
	699	700	701	702	703	704	705	706	707	708	709	710	711	712	713	714	715	716	717	718
	719	720	721	722 767 893 903 904 905 906 907 908 909 910 911 912 913 914 915 916
	917 918 919 920 921	922	993 1001 1002
	# Wushanko update
	1028 1029 1030 1031 1032
	1033 1034 1035 1036 1037 1038 1039 1040 1041 1042 1043 1044 1045 1046 1047 1048
	1049 1050 1051 1052 1053 1054 1055 1056 1057 1058 1059 1060 1061 1062 1063 1064
	1065 1066 1067 1068 1069 1070 1071 1072 1073 1074 1075 1076 1077 1078 1079 1080
	1081 1082 1083 1084 1085 1086 1087 1088 1089 1090 1091 1092 1093 1094 1095 1096
	# 1.3.0
	1250 1251
	1257 1258 1259 1260 1261 1262 1263 1264 1265 1266 1267 1268 1269 1270 1271 1272
	1273 1274 1275 1276 1277 1278 1279 1280 1281 1282 1283 1284
}

only_used_for_random = {
}

lakes = {
	28 31 53 141 207 208 109 240 241 243 244 246 297 298 299 300 302 304 319 320 321 343 375
	397 449 450 472 473 474 475 528 529 530
	723	724	725	726	727	728	729	730	731	732	733	734	735	736	737	738	739	740	741	742
	743	744	745	746	747	748	749	750	751	752
	763 800 801 802 803 804 898 899	994 995 996 997 998 999
	#New impassable seas
	592 1017 1018 1019 1020 1021 1022 1023 1024 1025 1026 1027
	#1.3.0
	1249
	1252 1253 1254 1255 1256
	1306 1307 1308 1309 1310
	1327 1328 1329 1330 1331 1332 1333 1334 1335 1336 1337 1338 1339 1340 1341 1342 1343
}

force_coastal = {
}

definitions = "definition.csv"
provinces = "provinces.bmp"
positions = "positions.txt"
terrain = "terrain.bmp"
rivers = "rivers.bmp"
terrain_definition = "terrain.txt"
heightmap = "heightmap.bmp"
tree_definition = "trees.bmp"
continent = "continent.txt"
adjacencies = "adjacencies.csv"
climate = "climate.txt"
region = "region.txt"
superregion = "superregion.txt"
area = "area.txt"
provincegroup = "provincegroup.txt"
ambient_object = "ambient_object.txt"
seasons = "seasons.txt"
trade_winds = "trade_winds.txt"
canal_definition = {
	name = "panama_canal"
	x = 1490
	y = 948
}
canal_definition = {
	name = "suez_canal"
	x = 3275
	y = 1118
}
canal_definition = {
	name = "kiel_canal"
	x = 2925
	y = 1587
}

# Define which indices in trees.bmp palette which should count as trees for automatic terrain assignment
tree = { 3 4 7 10 }